Sicherlich passend auch die aus der Sig zufällig ableitbaren
Marta Ucher, gerade auch in Verbindung mit Blähungen:

   Einakter  -- Prinzip Hoffnung...
   Keratines -- Da bläst's die Haare weg!
   antikeres -- muffig, really rotten rats
   Knauserei -- Ja wie, schon fertig?
   ausreiten -- Jawoll, gib's ihm!
   saunierte -- Was soll ein Po sonst machen?
   auskernte -- upps...
   ausrenkte -- dezent übertrieben
   Asketiker -- riecht nicht, klingt nicht
   sekkanter -- zieht voll durch
   Akustiker -- Achtung: Hörtest!  Eins, Zwei, ...
   Ankreisen -- damit's auch eine runde Sache wird
   Karniesen -- Auspuffschnupfen
   Ankeriten -- enthält festsetzende Bestandteile
   Nektarine -- Alle Mann in Deckung!
   Antiseren -- gesunde, heilende Abluft
   Arseniten -- So schaut's aus!
   Inseraten -- Suche: nächstes Fenster, aufmachbar
   Stearinen -- lange Brenndauer
   anreisten -- mit Ankündigung!  ETA: departed
   anstieren -- Opfer gezielt aussuchend
   astreinen -- *schmedderedeng!!!* (price winner)
   einrasten -- auf halbem Weg verkümmert
   sanierten -- auf die Freiheit vorbereitet worden
   erkanntes -- Wer hatte nochmal die Erbsensuppe?
   Kentauren -- Allmächt'ger!
   einsauten -- solang's keine zwei oder mehr werden...
   auskennte -- der Exit war eben geläufig
   Erstaunen -- Pure Physik: Ursache und Wirkung
   unreinste -- hat sich nicht gewaschen
   erstunken -- Aber das wenigstens ungelogen!
   trunkenes -- bierbedingt unvermeidlich
   Kanistern -- Bio-Gas auf Vorrat, aber
   riskanten -- wenn's dumm läuft:
   ausrinnet -- Ahoi, flüssiges Land!
   untersank -- Da ist man froh, wenn's dann die
   Kurtisanen
   austrinken

("Urinsekten" und "Uranisten" fand ich in diesem Zusammenhang viel
zu zweideutig, und habe sie aus diesem Grund auch nicht erwähnt.)


wilfried