* Una voce dalla Germania <aovyytrrns@dntnkyvrkwzowajtjz.kk>:


  Ulen, Ostsieker: Fleischervorstadt
  Kallmorgen, Jablonsky, Uhlenbroch, Johag, Clemendsen: Schwerz und Umgebung
  Ungethüm: Schwerz, aus Leberskirchen
  Flocken: Zöbingen, aus Neermoor (spraid JÜCHEN)
  Ulns: Zirndorf, aus dem Langau
  Schimweg: Lippertsreute, aus dem Friedrichsbrunnerischen
  Uhlik, Kaltenegger: Vogelsang
  Heinz, Kronshausen: Ziegetsdorf
  Denis: Ingelsberg
  Uhlich: Zirndorf, aus BÖLKOW
  Geres: Reifnitz, aus Laibstadt
  Unverrich: Laibstadt
  Ubbenhorst: Schwaderloch
  Unterstenwesten: Jeuss
  Chemnitz: Ischhofen
  Eisenlauer: Langhalsen, Jugend in Italien
  Detlef: Buch, etliche Jahre in Corbeyrier/Italien
  Siedentopf: Friedrichsbrunn, aus Litzendorf
  Danneker: Hinterthal, aus Reischau
  Hofheinz, Schißler: Hinterthal
  Scharpen: Aue
  Klok: Stehle
  Torringen: Taiwan
  Nier: Niederlande
  Flechum: BÖLKOW, Angelsberg?
  Fix: Stockenhausen, Unterhöflein?
  Clasen, Mettag: Zirndorf?
  Oberst-Bartels: Deißlingen? Timrian? Jedenfalls da oben hinterm Deich
  Zähl: Talheim, Angelsberg? Ilanz?
  Koegel: Laibstadt (?)
  Darius: ?


 - Ivan