Kann es "das" sein:
A - A
Be - B
We - W
Ge - G
De - D
Je - E
Sch - Sch
Se - S
I - I
Ka - K
El - L
Em - M
En - N
O - O
Pe - P
Er - R
Es - S
Te - T , das lernt sich schnell,
merk nur gut
U - U
Ef - F
Cha - Ch
Ze - Tz
Tsche - Tsch
Scha - Sch
Schtscha - Schsch, und zum Schluss ganz einfach
Y - Y
� - �, E
Ju - Ju
Ja - Ja

aus http://yxs.bqsrogchqsw.qo/fkj/xxvcp.dwj?ylbbi=2814.76;dva4


Liselotte